t....f...t
+.c..c..c+
x........x
+..c...c.+
x....c...x
+..c.....+
x.....c..x
+c.......+
x...c....x
+........+
x........x
+........+
x........x
+........+
x....A...x