tccccf..ct
+sss.s..s+
x.....sc.x
+........+
x........x
+........+
x........x
+........+
x........x
+........+
x........x
+........+
x........x
+........+
x....A...x