tccc..csct
+ss..s.ss+
x....f...x
+........+
x........x
+........+
x........x
+........+
x........x
+........+
x........x
+........+
x........x
+........+
x....A...x