t....f...t
+........+
xss....ssx
+........+
x..ssss..x
+........+
xss....ssx
+........+
x..ssss..x
+........+
x........x
+........+
x........x
+........+
x....A...x