tc.fc..c.t
+........+
x.c..c..cx
+.....c..+
x..c.....x
+....ccc.+
x........x
+ccc.....+
x........x
+........+
x........x
+........+
x........x
+........+
x....A...x