t.....f..t
+........+
x........x
+........+
x........x
+........+
x........x
+....A...+
x........x
+........+
x........x
+........+
x........x
+........+
x........x