t.s.s..sft
+..c.s...+
x.......cx
+........+
x........x
+........+
x........x
+........+
x........x
+........+
x........x
+........+
x........x
+........+
x....A...x