t.....f..t
+ssss.sss+
x........x
+sss.ssss+
x........x
+........+
x........x
+........+
x........x
+........+
x........x
+........+
x........x
+........+
x....A...x