t....f...t
+.s..s..s+
x........x
+..s...s.+
x....s...x
+..s.....+
x.....s..x
+s.......+
x...s....x
+........+
x........x
+........+
x........x
+........+
x....A...x