tssc.ccsst
+..fss...+
x........x
+........+
x........x
+........+
x........x
+........+
x........x
+........+
x........x
+........+
x........x
+........+
x....A...x