t....cfc.t
+..s.....+
xs......sx
+..c.....+
x........x
+c..c..c.+
x........x
+........+
x........x
+........+
x........x
+........+
x........x
+........+
x....A...x