t.s.s.f.st
+........+
x........x
+..s..s..+
x........x
+.s.s.s..+
x........x
+........+
x........x
+........+
x........x
+........+
x........x
+........+
x...A....x