t.....f..t
+..cc.cc.+
x........x
+........+
x.ccc..c.x
+c......c+
x........x
+.ccccc..+
x........x
+........+
x........x
+........+
x........x
+........+
x....A...x