t....f...t
+.c..s..s+
x........x
+..s...s.+
x....c...x
+..s.....+
x.....c..x
+s.......+
x...s....x
+........+
x........x
+........+
x........x
+........+
x....A...x