t....f...t
+..c..cs.+
x.s..s...x
+........+
x........x
+........+
x........x
+........+
x........x
+........+
x........x
+........+
x........x
+........+
x....A...x